NO textures/a.xpm
SO textures/b.xpm
WE textures/brick.xpm
EA textures/brick.xpm

F 45,113,39
C 51,198,190

         111111111  111111111111111111
         100000011  100000000000000001
         1100100011110000001111111111
1111111111000100000000000011111
100000001111000100N0000001001
10000011  110110101110000001
10000001111110000001 10100001
11111111111111111111 11111111
     
1111 111111111111111111111111
1011 100000000000000000000001
1111 111111111111111111111111
