NO ./textures/brick.xpm
SO ./textures/blue.xpm
EA ./textures/grey.xpm
WE ./textures/wood.xpm

F 255,9,33
C 21,221,42

111111111
1000000001 111
100000001 101
100N000001 111
1000000001
1000000001
1000011111 
1000000011111111111111
1000000000000000000001
11110011100111111110011111
1111100111011     10011
11111111111        100011111
1011101111          1000000011
10111111             1111111111
11