NO ./textures/brick.xpm
SO ./textures/blue.xpm
EA ./textures/grey.xpm
WE ./textures/wood.xpm

F 21,95,214
C 148,7,68

1111111111
1000000001 111
1000000001 101
1000000001 111
1000000001
1000000001
1000N0011111 
100000001111
100000000001
111100111001
1111100111011                     111111111
1111111111111                     111 111
11011101111                        111111
111111111                   111111
11111