NO textures/brick.xpm
SO textures/brick.xpm
WE textures/brick2.xpm
EA textures/brick2.xpm

F 150,75,0
C 41,13,119

         11111111111111111111111111111
         10000000001100000000000000001
         10110000011100000001111111111
1111111110000000000000000011111
        101100000111000000000111111
111111111001100000111011111011
11110111111111011100000010001
11110111111111011101010010001
11000000110101011100000010001
10000000000000001100000010001
10000000000000001100010000001
11000000110101000000000000001
11110111110101000000000000001
10000000001100000100000010001
10000000000000000000000001001   111
10000000111100010000000001001               
100000001  100110101110000001   111
10000000111110000001 10100001
11111111111111101111 11100111
         11111101111111100111111111111
         10000000001100000000000000001
         10110000011100000001111111111
11111111110000000000000000011111
        101100000111000000000111111
111111111001100000111011111011
11111111111111011100000010001
11110111111111011101010010001
11000000110101011100000010001
10000000000000001100000010001
1000000000000000110001000001111111111111111111
11000000110101000000000000001   111          1
11110111110101000000000000001   101          1
10000000001100000100000010001   111          1
10000000000000000N000000010011111111111111111111
1000000111100010000000001001
100000001  100110101110000001
10000000111110000001 10100001
11111111111111111111 11111111
