NO ./textures/brick.xpm
SO ./textures/blue.xpm
EA ./textures/grey.xpm
WE ./textures/wood.xpm

F 21,95,214
C 148,7,68

111111111
1000000001 111
100000001 101
1000000001 111
1000000001
1000000001
1000011111 
100000001111
100000N00001
111100111001
1111100111011                     111111111
1111111111                    111 111
1011101111                        11111
10111111                   111111
11