NO ./textures/brick.xpm
SO ./textures/blue.xpm
EA ./textures/grey.xpm
WE ./textures/wood.xpm

F 100,0,255
C 0,0,0

111111
100001
100001
111N111
111111