NO ./textures/brick.xpm
SO ./textures/blue.xpm
EA ./textures/grey.xpm
WE ./textures/wood.xpm

F 100,0,255
C 0,0,0

111111
100101                          111111
101001                  111111111100011111
1100N11111111               1111111111
111111