NO ./textures/brick.xpm
SO ./textures/blue.xpm
EA ./textures/grey.xpm
WE ./textures/wood.xpm

F 100,0,255
C 0,0,0

11111111111
1N00000001
1000000001
1000000001
1000000001
1000000001
1000N0011111
100000001
1000000001
1111001111
111110011111                     1111111111
11111101111
111111111                   111111
1111