NO ./textures/brick.xpm
SO ./textures/blue.xpm
EA ./textures/grey.xpm
WE ./textures/wood.xpm

F 100,0,255
C 0,0,0

111111111
10010101                          111111
1010011                  111111111100011111
1100N11111111               1111111111
1111111111111
1111111111               1111111111